#
# acronym (tab) definition
#
# The definition should be text that could be used
# as a standalone replacement of the acronym as used
# in a sentence. Should not contain "meaning"
#
# These are too ambigious to replace mechanically:
#
# - AT	At your terminal
# - ;S	Gentle warning, like “Hmm? What did you say?”
# - ?	I don't understand what you mean
#
#
.02	My two cents worth
10Q	Thank you
10X	Thanks
121	One-to-one
1337	Leet, meaning ‘elite'
143	I love you
1432	I love you too
14AA41	One for all, and all for one
182	I hate you
1CE	Once
1DR	I wonder
1NAM	One in a million
20	location
2B	To be
2EZ	Too easy
2G2BT	Too good to be true
2M2H	Too much to handle
2MI	Too much information
2MOR	Tomorrow
2MORO	Tomorrow
2N8	Tonight
2NTE	Tonight
2p	My 2 opinion
404	I don't know
411	information
420	Lets get high
420	Marijuana
459	Means I love you
4AO	For adults only
4COL	For crying out loud
4EAE	Forever and ever
4EVA	Forever
4NR	Foreigner
4SALE	For sale
511	Too much information
555	Sobbing, crying.
55555	Crying your eyes out
6Y	Sexy
7K	Sick
81	Hells Angels
831	I love you
86	Over
88	Hugs and kisses
9	Parent is watching
?4U	I have a question for you
@TEOTD	At the end of the day
A/N	Author's note
A/S/L	Age/sex/location
A3	Anytime, anywhere, anyplace
AA	Ask about
AAF	As a friend
AAF	As a matter of fact
AAK	Asleep at keyboard
AAMOF	As a matter of fact
AAMOI	As a matter of interest
AAP	Always a pleasure
AAR	At any rate
AAS	Alive and smiling
AASHTA	As always, Sheldon has the answer
AATK	Always at the keyboard
AAYF	As always, your friend
ABBR	abbreviation
ABC	Already been chewed
ABD	Already been done
ABT	About
ABT2	About to
ABTA	Good-bye
ABU	All bugged up
AC	Acceptable content
ACC	Anyone can come
ACD	ALT / CONTROL / DELETE
ACDNT	Accident
ACE	marijuana cigarette
ACK	Acknowledge
ACPT	Accept
ACQSTN	Acquisition
ADAD	Another day, another dollar
ADBB	All done, bye-bye
ADD	Address
ADDY	Address
ADIH	Another day in hell
ADIP	Another day in paradise
ADMIN	Administrator
ADMINR	Administrator
ADN	Any day now
ADR	Address
AEAP	As early as possible
AF	As fuck
AFAIAA	As far as I am aware
AFAIC	As far as I am concerned
AFAIK	As far as I know
AFAIUI	As far as I understand it
AFAP	As far as possible
AFC	Away from computer
AFFA	Angels Forever, Forever Angels
AFJ	April Fool's joke
AFK	Away from keyboard
AFPOE	A fresh pair of eyes
AFZ	Acronym Free Zone
AH	At home
AIAMU	And I am a money's uncle
AIGHT	Alright
AIR	As I remember
AISB	As I said before
AISI	As I see it
AITR	Adult in the room
AKA	Also known as
ALCON	All concerned
ALOL	Actually laughing out loud
AMA	Ask me anything
AMAP	As much as possible
AMBW	All my best wishes
AML	All my love
AMOF	As a matter of fact
AOC	Available on cell
AOM	Age of majority
AOTA	All of the above
AOYP	Angel on your pillow
APAC	All praise and credit
APP	Application
APP	Appreciate
AQAP	As quick as possible
ARC	Archive
ARG	Argument
ASAP	As soon as possible
ASIG	And so it goes
ASL	Age/sex/location
ASLA	Age/sex/location/availability
ATB	All the best
ATEOTD	At the end of the day
ATM	At the moment
ATSITS	All the stars in the sky
ATSL	Along the same line
AWC	After awhile crocodile
AWESO	Awesome
AWOL	Absent without leave
AWOL	Away without leaving
AYDY	Are you done yet?
AYEC	At your earliest convenience
AYOR	At your own risk
AYS	Are you serious?
AYSOS	Are you stupid or something?
AYT	Are you there?
AYTMTB	And you're telling me this because
AYV	Are you vertical?
AYW	As you want / As you wish
AYW	As you were
AZN	Asian
B&	Banned
B-DAY	Birthday
B/C	Because
B/F	Boyfriend
B/G	Background
B2B	Business-to-business
B2C	Business-to-consumer
B2W	Back to work
B4	Before
B4N	Bye for now
B8	Bait
B9	Boss is watching
BA	Bad a
BAE	Babe
BAE	Before anyone else
BAFO	Best and final offer
BAG	Busting a gut
BAK	Back at keyboard
BAM	Below average mentality
BAMF	Bad a mother f
BAO	Be aware of
BAS	Big ass smile
BASIC	mainstream
BASOR	Breathing a sigh of relief
BAU	Business as usual
BAY	Back at ya
BB	Baby
BB	Be back
BB	Big brother
BBC	Big bad challenge
BBIAB	Be back in a bit
BBIAF	Be back in a few
BBIAM	Be back in a minute
BBIAS	Be back in a sec
BBL	Be back later
BBN	Bye, bye now
BBS	Be back soon
BBT	Be back tomorrow
BC	Be cool
BC	Because
BCNU	Be seeing you
BCO	Big crush on
BCOS	Because
BCOY	Big crush on you
BD	Big deal
BDAY	Birthday
BDN	Big darn number
BEG	Big evil grin
BF	Best friend
BF	Boyfriend
BF	Brain fart
BFAW	Best friend at work
BFD	Big fucking deal
BFF	Best friends forever
BFFL	Best friends for life
BFFLNMW	Best friends for life, no matter what
BFFN	Best friend for now
BFG	Big fucking grin
BFN	Bye for now
BG	Big grin
BGWM	Be gentle with me
BHL8	Be home late
BIB	Boss is back
BIBO	Beer in, beer out
BIC	Butt in chair
BIF	Before I forget
BIH	Burn in hell
BIL	Brother in law
BIO	Bathroom break
BION	Believe it or not
BIOYA	Blow it out your a
BIOYN	Blow it out your nose
BISFLATM	Boy, I sure feel like a turquoise monkey!
BITMT	But in the meantime
BL	Belly laugh
BLNT	Better luck next time
BM	Bite me
BM&Y	Between me and you
BME	Based on my experience
BMS	Broke my scale, used when rating someone
BN	Bad news
BOB	Back off buddy
BOHICA	Bend over here it comes again
BOL	Best of luck
BOLO	Be on the look out
BOM	b of mine
BOOMS	Bored out of my skull
BOSMKL	Bending over smacking my knee laughing
BOT	Back on topic
BOT	Be on that
BOYF	Boyfriend
BPLM	Big person little mind
BR	Best regards
BRB	Be right back
BRBB	Be right back b
BRD	Bored
BRH	Be right here
BRNC	Be right back, nature calls
BRT	Be right there
BSF	But seriously folks
BSOD	Blue screen of death
BSTS	Better safe than sorry
BT	Between technologies
BT	Bite this
BTA	But then again
BTDT	Been there, done that
BTW	By the way
BTYCL	Bootycall
BUBU	Slang term for the most beautiful of women
BURN	Used to reference an insult
BWL	Bursting with laughter
BYO	Bring your own
BYOB	Bring your own beer
BYOC	Bring your own computer
BYOD	Bring your own device
BYOH	Bat you on the head
BYOP	Bring your own paint
BYTM	Better you than me
Bloke	Man
C&G	Chuckle & grin
C/P	Cross post
C4N	Ciao for now
CAD	Control + Alt + Delete
CAD	Short for Canada/Canadian
CAM	Camera
CB	Chat break
CB	Coffee break
CB	Crazy b
CD9	parents are around
CFS	Care for secret?
CFY	Calling for you
CHK	Check
CIAO	Good-bye
CICO	Coffee in, coffee out
CID	Consider it done
CID	Crying in disgrace
CLAB	Crying like a baby
CLD	Could
CLK	Click
CM	Call me
CMB	Call me back
CMGR	Community manager
CMIIW	Correct me if I'm wrong
CMON	Come on
CNP	Continued in next post
COB	Close of business
COS	Because
CR8	Create
CRA CRA	Slang term meaning “crazy”
CRAFT	Can't remember a fucking thing
CRB	Come right back
CRBT	Crying really big tears
CRE8	Create
CRS	Can't remember stuff
CRZ	Crazy
CSG	Chuckle, snicker, grin
CSL	Can't stop laughing
CT	Can't talk
CTC	Care to chat?
CTHU	Cracking the heck up
CTN	Can't talk now
CTO	Check this out
CU	See you
CU2	See you too
CUA	See you around
CUL	See you later
CUL8R	See you later
CULA	See you later alligator
CUMID	See you in my dreams
CURLO	See you around like a donut
CWD	Comment when done
CWOT	Complete waste of time
CWYL	Chat with you later
CX	Correction
CYA	See you
CYAL8R	See you later
CYE	Check your e-mail
Cakeday	Birthday
Cray	crazy
D/L	Download
D00D	Dude
D2	Dedos or fingers
D46?	Down for sex?
DA	The
DAE	Does anyone else?
DAFUQ	What the Fuck?
DAM	Don't annoy me
DBAU	Doing business as usual
DBEYR	Don't believe everything you read
DC	Disconnect
DD	Dear daughter
DD	Due diligence
DDG	Drop dead gorgeous
DEGT	Dear daughter
DERP	stupid or silly
DF	Don't even go there
DGA	Don't go anywhere
DGAF	Don't give a fuck
DGT	Don't go there
DGTG	Don't go there, girlfriend
DGYF	Dang, girl you fine
DH	Dear husband
DHU	Dinosaur hugs
DIIK	Darned if I know
DIKU	Do I know you?
DILLIGAF	Do I look like I give a fuck?
DILLIGAS	Do I look like I give a sugar?
DIS	Did I say?
DITYID	Did I tell you I'm distressed?
DIY	Do it yourself
DKDC	Don't know, don't care
DL	Dead link
DL	Down low
DL	Download
DLBBB	Don't let bed bugs bite
DLTBBB	Don't let the bed bugs bite
DM	Direct message
DM	Do me
DM	Doesn't matter
DMNO	Dude Man No Offense
DMY	Don't mess yourself
DN	Down
DNC	Do not compute
DNR	Dinner
DNT	Don't
DOE	Daughter of Eve
DORBS	Adorable
DQMOT	Don't quote me on this
DR	Didn't read
DS	Dear son
DTR	Define the relationship
DTRT	Do the right thing
DTS	Don't think so
DTTD	Don't touch that dial
DUPE	Duplicate
DUR	Do you remember?
DV8	Deviate
DW	Dear wife
DWF	Divorced white female
DWM	Divorced white male
DXNRY	Dictionary
DYFI	Did you find it?
DYFM	Dude, you fascinate me
DYJHIW	Don't you just hate it when…?
DYNWUTB	Do you know what you are talking about?
DYOR	Do your own research
Downvote	Voting negatively on a thread using Reddit s voting system
E	Ecstasy
E1	Everyone
E123	Easy as one, two, three
E2EG	Ear to ear grin
EAK	Eating at keyboard
EBKAC	Error between keyboard and chair
ED	Erase display
EF4T	Effort
EG	Evil grin
EI	Eat it
EIP	Editing in progress
ELI5	Explain like I'm 5
EM	E-mail
EMA	E-mail address
EMBAR	Embarassing
EMFBI	Excuse me for butting in
EMFBI	Excuse me for jumping in
EMSG	E-mail message
ENUF	Enough
EOD	End of day
EOL	End of life
EOM	End of message
EOS	End of show
EOT	End of transmission
ERS2	Eres or are you
ES	Erase screen
ESAD	Eat S and die!
ETA	Edited to add
ETA	Estimated time arrival
EVA	Ever
EVO	Evolution
EWG	Evil wicked grin
EWI	Emailing while intoxicated
EXTRA	over the top
EYC	Excitable, yet calm
EZ	Easy
EZY	Easy
F	female
F2F	Face to face
F4F	Follow for follow
FAAK	Falling asleep at keyboard
FAB	Fabulous
FAF	Funny as fuck
FAM	Family, but not limited to actual family members. Could mean friends.
FAQ	Frequently asked questions
FAY	Fuck all you
FB	Facebook
FBB	Facebook buddy
FBC	Facebook chat
FBF	Facebook friend
FBF	Fat boy food
FBF	Flashback Friday
FBFR	FaceBook friend
FBM	Fine by me
FBO	Facebook official
FBOW	For better or worse
FC	Fingers crossed
FC'INGO	For crying out loud
FCOL	For crying out loud
FEITCTAJ	Fuck 'em if they can't take a joke
FF	Follow Friday
FFS	For fuck sakes
FICCL	Frankly I couldn't care a less
FIF	Fuck I'm funny
FIIK	Fucked if I know
FIIOOH	Forget it, I'm out of here
FIL	Father in law
FIMH	Forever in my heart
FISH	First in, still here
FITB	Fill in the blank
FML	Fuck My Life
FOAD	Fuck off and die
FOAF	Friend of a friend
FOMC	Falling off my chair
FOMCL	Falling off my chair laughing
FOMO	Fear of missing out
FRT	For real though
FTBOMH	From the bottom of my heart
FTFY	Fixed that for you
FTL	For the loss
FTW	For the win
FU	Fuck you
FUBAR	Fouled up beyond all recognition
FUBB	Fouled up beyond belief
FUTAB	Feet up, take a break
FW	Forward
FWB	Friend with benefits
FWIW	For what it's worth
FWM	Fine with me
FWP	First world problems
FYA	For your amusement
FYE	Fire, something that is cool
FYEO	For your eyes only
FYI	For your information
Facepalm	Used to represent the gesture of “smacking your forehead with your palm” to express embarrassment or frustration
Feelsbadman	A social meme that means to feel negative.
Feelsbatman	A social meme taking “feelsbadman” to the extreme. This references the DC super hero Batmanbecause he witnessed the murder of his parents.
Feelsgoodman	A social meme that means to feel positive.
Finna	Means “Going to”
Finsta	A second Instagram account where someone can post things that they're too afraid to post on their main account.
G/F	Girlfriend
G2CU	Good to see you
G2G	Got to go
G2GICYAL8ER	Got to go I'll see you later
G2R	Got to run
G2TU	Got to tell you
G4C	Going for coffee
G9	Genius
GA	Go ahead
GAC	Get a clue
GAFC	Get a fucking clue
GAL	Get a life
GAS	Got a second?
GAS	Greetings and salutations
GB	Goodbye
GBTW	Get back to work
GBU	God bless you
GD	Good
GD/R	Grinning, ducking, and running
GDR	Grinning, ducking, and running
GF	Girl friend
GF	Girlfriend
GFI	Go for it
GFN	Gone for now
GG	Brother
GG	Gotta Go
GGMSOT	Gotta get me some of that
GGOH	Gotta Get Outa Here
GGP	Got to go pee
GGU2	Good game, you too
GIAR	Give it a rest
GIGO	Garbage in, garbage out
GIRL	Guy in real life
GJ	Good job
GL	Good luck
GMBA	Giggling my butt off
GMTA	Great minds think alike
GMV	Got my vote
GN	Good night
GNA	Good night all
GNE1	Good night everyone
GNIGHT	Good night
GNITE	Good night
GNSD	Good night, sweet dreams
GOAT	Greatest of all Time
GOI	Get over it
GOL	Giggling out loud
GOMB	Get off my back
GPOY	Gratuitous picture of yourself
GR&D	Grinning, running and ducking
GR8	Great
GRATZ	Congratulations
GRL	Girl
GRWG	Get right with God
GS	Good shot
GT	Good try
GTFO	Get the fuck out
GTFOH	Get the fuck outta here
GTG	Got to go
GTM	Giggling to myself
GTRM	Going to read mail
GTSY	Great to see you
GUCCI	Good
GUD	Good
GWHTLC	Glad we had this little chat
H&K	Hugs & kisses
H-BDAY	Happy Birthday
H-FDAY	Happy Father's Day
H-MDAY	Happy Mother's Day
H2CUS	Hope to see you soon
H8	Hate
H8TTU	Hate to be you
HAG1	Have a good one
HAGN	Have a good night
HAGO	Have a good one
HAK	Hug and kiss
HALP	Help
HAND	Have a nice day
HAU	How about you?
HAWT	Have a wonderful time
HAWT	sexy
HB	Hug back
HB	Hurry back
HBD	Happy birthday
HBU	How about you?
HF	Have fun
HFAC	Holy flipping animal crackers
HHIS	Head hanging in shame
HIFW	How I felt when ...
HLA	Hola
HMU	Hit me up
HNL	whole other level
HOAS	Hold on a second
HRU	How are you?
HTH	Hope this helps
HUB	Head up butt
HUYA	Head up your butt
HV	Have
HW	Homework
HYFR	Hell yeah, Fucking right!
I2	I too
IA8	I already ate
IAAA	I am an accountant
IAAD	I am a doctor
IAAL	I am a lawyer
IAC	In any case
IAE	In any event
IANAC	I am not a crook
IANAL	I am not a lawyer
IAO	I am out
IB	I'm back
IC	I see
ICAM	I couldn't agree more
ICBW	It could be worse
ICEDI	I can't even discuss it
ICFILWU	I could fall in love with you
ICYMI	In case you missed it
IDBI	I don't believe it
IDC	I don't care
IDGAF	I don't give a fuck
IDK	I don't know
IDTS	I don't think so
IDUNNO	I don't know
IFYP	I feel your pain
IG	Instagram
IG2R	I got to run
IGHT	I got high tonight
IGN	I got nothing
IGP	I got to pee
IHNI	I have no idea
IIIO	Intel inside, idiot outside
IIRC	If I remember correctly
IK	I know
IKR	I know, right?
ILBL8	I'll be late
ILU	I love you
ILUM	I love you man
ILY	I love you
ILYSM	I love you so much
IM	Instant message
IMAO	In my arrogant opinion
IMHO	In my humble opinion
IMNSHO	In my not so humble opinion
IMO	In my opinion
IMS	I am sorry
IMSB	I am so bored
IMTM	I am the man
IMU	I miss you
INAL	I'm not a lawyer
INV	Invite
IOMH	In over my head
IOW	In other words
IRL	In real life
IRMC	I rest my case
ISLY	I still love you
ISO	In search of
ITAM	It's The Accounting, Man
ITT	In This Thread
ITYK	I thought you knew
IUSS	If you say so
IWALU	I will always love you
IWAWO	I want a way out
IWIAM	Idiot wrapped in a moron
IWSN	I want sex now
IYKWIM	If you know what I mean
IYO	In your opinion
IYQ	I like you
IYSS	If you say so
J00	You
J00r	Your
JAC	Just a second
JAM	Just a minute
JAS	Just a second
JC	Just checking
JDI	Just do it
JELLY	jealous
JFF	Just for fun
JFGI	Just fucking Google it
JIC	Just in case
JJ	Just joking
JJA	Just joking around
JK	Just kidding
JLMK	Just let me know
JMO	Just my opinion
JP	Just playing
JT	Just teasing
JTLYK	Just to let you know
JV	Joint venture
JW	Just wondering
K	Okay
K8T	Katie
KB	Keyboard
KDFU	Means Cracking the fuck up
KEWL	Cool
KEYA	I will key you later
KEYME	Key me when you get in
KFY	Kiss for you
KIA	Know it all
KIR	Keep it real
KISS	Keep it simple, stupid
KIT	Keep in touch
KK	Knock, knock
KK	Okay, Okay!
KMA	Kiss my a
KMK	Kiss my keister
KMS	Killing myself
KMT	Kiss my tushie
KNIM	Know what I mean?
KNOW	knowledge
KOC	Kiss on cheek
KOL	Key opinion leader
KOS	Kid over shoulder
KOTC	Kiss on the cheek
KOTD	Kicks of the day
KOTL	Kiss on the lips
KOW	Knock on wood
KPC	Keeping parents clueless
KSC	Kind of sort of chuckle
KT	Katie
KUTGW	Keep up the good work
KYS	Kill yourself
Koreaboo	Someone obsessed with Korean culture
L2G	Like to go?
L2G	would Love to go
L2K	Like to come
L2P	Learn to play
L33T	Leet, meaning ‘elite'
L4L	Like for like
L8R	Later
L8RG8R	Later, gator
LAB	Life's a b
LBAY	Laughing back at you
LBS	Laughing, but serious
LBVS	Laughing, but very serious
LD	Later, dude
LD	Long distance
LDO	Like, duh obviously
LEMENO	Let me know
LERK	Leaving easy reach of keyboard
LFD	Left for day
LGH	Lets get high
LH6	Lets have sex
LHM	Lord help me
LHO	Laughing head off
LHSX	Lets have sex
LI	LinkedIn
LIC	Like I care
LIK	liquor
LIMT	Laugh in my tummy
LIT	Extremely intoxicated
LIT	really good
LLGB	Love, later, God bless
LLS	Laughing like silly
LMAO	Laughing my arse off
LMBO	Laughing my butt off
LMFAO	Laughing my fucking a off
LMIRL	Lets meet in real life
LMK	Let me know
LMMFAO	Laughing my mother fucking a off
LMNK	Leave my name out
LMS	Like my status
LNT	lost in translation
LOA	List of acronyms
LOL	Laugh out loud
LOLH	Laughing out loud hysterically
LOLO	Lots of love
LOLWTF	Laughing out loud saying "What the fuck?"
LOTI	Laughing on the inside
LQTM	Laughing quietly to myself
LSHMBH	Laugh so hard my belly hurts
LSV	Language, sex and violence
LTD	Living the dream
LTLWDLS	Let's twist like we did last summer
LTNS	Long time no see
LTOD	Laptop of death
LTS	Laughing to self
LULT	Love you long time
LULZ	for laughs
LVM	Left voice mail
LWOS	Laughing without smiling
LY	Love ya
LYLAS	Love you like a sis
LYLC	Love you like crazy
LYSM	Love you so much
M$	Microsoft
M8	Mate
MB	Mamma's boy
MBS	Mom behind shoulder
MC	Merry Christmas
MDIAC	My Dad is a cop
MEGO	My eyes glaze over
MEH	mediocre
MEHH	sigh
MFI	Mad for it
MFW	My face when ...
MGB	May God bless
MGMT	Management
MHOTY	My hat is off to you
MIRL	Me in real life
MIRL	Meet in real life
MKAY	Mmm, okay
MLM	middle finger
MM	Sister
MMK	Meaning okay?
MNC	Mother nature calls
MOD	Moderator
MOMBOY	Mamma's boy
MOO	My own opinion
MOOS	Member of the opposite sex
MORF	Male or female?
MOS	Mother over shoulder
MOSS	Member of same sex
MRT	Modified ReTweet
MRW	My reaction when ...
MSG	Message
MTF	More to follow
MTFBWU	May the force be with you
MU	Miss you
MUAH	Multiple unsuccessful attempts at humour
MUSM	Miss you so much
MWAH	kiss
MYO	Mind your own
MYOB	Mind your own business
N00B	Newbie
N1	Nice one
N2M	Nothing too much
NADT	Not a darn thing
NALOPKT	Not a lot of people know that
NANA	Not now, no need
NBD	No big deal
NE	Any
NE1	Anyone
NFM	Not for me
NFS	Not for sale
NFW	No fucking way
NFWS	Not for work safe
NGL	Not going to lie
NIFOC	Naked in front of computer
NIGI	Now I get it
NIMBY	Not in my back yard
NIROK	Not in reach of keyboard
NLT	No later than
NM	Never mind
NM	Nothing much
NMH	Not much here
NMJC	Nothing much, just chilling
NMU	Not much, you?
NO1	No one
NOWL	knowledge
NOYB	None of your business
NP	No problem
NPC	Non-playing character
NQT	Newly qualified teacher
NRN	No response/reply necessary
NSA	No strings attached
NSFL	Not safe for life
NSFW	Not safe for work
NSISR	Not sure if spelled right
NT	Nice try
NTHING	Nothing
NTS	Note to self
NVM	Never mind
NVR	Never
NW	No way
NWO	No way out
O4U	Only for you
OATUS	On a totally unrelated subject
OB	Oh brother
OBV	Obviously
OFC	Of course
OG	Original gangster
OGIM	Oh God, it's Monday
OH	Overheard
OI	Operator indisposed
OIB	Oh, I'm back
OIC	Oh, I see
OJ	Only joking
OL	Old lady
OLL	Online love
OM	Oh, my
OM	Old man
OMAA	Oh, my aching A arse
OMDB	Over my dead body
OMFG	Oh my fucking God
OMG	Oh my God
OMG	Oh my gosh
OMGYG2BK	Oh my God, you got to be kidding
OMGYS	Oh my gosh you suck
OMS	On my soul
OMW	On my way
ONL	Online
OO	Over and out
OOC	Out of character
OOH	Out of here
OOMF	One of my followers
OOTD	One of these days
OOTD	Outfit of the day
OOTO	Out of the office
OP	On phone
ORLY	Oh really?
OS	Operating system
OT	Off topic
OTB	Off to bed
OTFL	On the floor laughing
OTL	Out to lunch
OTOH	On the other hand
OTP	On the phone
OTP	One true pairing; two people you would love to see as a couple
OTT	Over the top
OTTOMH	Off the top of my head
OTW	Off to work
OVA	Over
OYO	On your own
P2P	Parent to parent
P2P	Peer to peer
P911	Parents coming into room alert
PAP	Post a picture
PAW	Parents are watching
PBOOK	Phonebook
PCM	Please call me
PDA	Personal display of affection
PDH	Pretty darn happy
PDQ	Pretty darn quick
PDS	Please don't shoot
PEEPS	People
PFT	Pretty fucking tight
PIC	Picture
PIP	Peeing in pants
PIR	Parents in room
PISS	Put in some sugar
PITA	Pain in the butt
PL8	Plate
PLD	Played
PLMK	Please let me know
PLS	Please
PLU	People like us
PLZ	Please
PLZTLME	Please tell me
PM	Private Message
PMFI	Pardon me for interrupting
PMFJI	Pardon me for jumping in
PMSL	Pee myself laughing
POAHF	Put on a happy face
POIDH	Picture, or it didn't happen
POS	Parent over shoulder
POTD	Photo of the day
POV	Point of view
PPL	People
PPU	Pending pick-up
PRESH	Precious
PROBS	Probably
PROGGY	computer program
PROLLY	Probably
PRON	pornography
PRT	Party
PRT	Please Retweet
PRW	People are watching
PSA	Public Service Announcement
PSOS	Parent standing over shoulder
PSP	Playstation Portable
PTFO	Pass the fuck out
PTIYPASI	Put that in your pipe and smoke it
PTL	Praise the Lord
PTMM	Please tell me more
PTO	Paid time off
PTO	Parent Teacher Organization
PTO	Personal time off
PU	That stinks!
PUKS	Pick up kids
PWN	own
PXT	Please explain that
PYT	Pretty young thing
PZ	Peace
PZA	Pizza
Q	Queue
Q4U	I have a question for you
QC	Quality control
QFE	Question for everyone
QFI	Quoted for idiocy
QFI	Quoted for irony
QFT	Quoted for truth
QIK	Quick
QL	Quit laughing
QOTD	Quote of the day
QQ	Quick question
QSL	Reply
QSO	Conversation
QT	Cutie
QTPI	Cutie pie
Q_Q	crying eyes
R	are
R8	Rate
RBAY	Right back at you
RFN	Right fucking now
RGR	I understand
RHIP	Rank has its privileges
RIP	Rest in peace
RL	Real life
RLY	Really
RME	Rolling my eyes
RMLB	Read my lips baby
RMMM	Read my mail man
ROFL	Rolling on floor laughing
ROFLCOPTER	Rolling on floor laughing and spinning around
ROFLMAO	Rolling on the floor, laughing my butt off
ROTFL	Rolling on the floor laughing
ROTFLUTS	Rolling on the floor laughing unable to speak
RS	Runescape
RSN	Real soon now
RT	Retweet
RT	Roger that
RTBS	Reason to be single
RTFM	Read the fucking manual
RTFQ	Read the fucking question
RTHX	Thanks for the Retweet
RTMS	Read the manual, stupid
RTSM	Read the stupid manual
RTWFQ	Read the whole fucking question
RU	Are you?
RUMOF	Are you male or female?
RUOK	Are you okay?
RUT	Are you there?
RW	Real world
RX	Regards
RX	prescription drugs
RYB	Read your Bible
RYO	Roll your own
RYS	Are you single?
RYS	Read your screen
S2R	Send to receive
S2S	Sorry to say
S4L	Spam for life
SAL	Such a laugh
SAT	Sorry about that
SAVAGE	Slang for a shockingly careless expression or response to an event or message
SB	Should be
SB	Smiling back
SB	Snap back
SBIA	Standing back in amazement
SBT	Sorry 'bout that
SC	Stay cool
SD	Sweet dreams
SDMB	Sweet dreams, my baby
SELFIE	self portrait
SENPAI	someone older than you
SEO	Search engine optimization
SETE	Smiling Ear-to-Ear
SFAIK	So far as I know
SH	Same here
SHID	Slapping head in disgust
SHIP	relationship
SH^	Shut up
SICNR	Sorry, I could not resist
SIG2R	Sorry, I got to run
SIHTH	Stupidity is hard to take
SIMYC	Sorry I missed your call
SIR	Strike it rich
SIS	Snickering in silence
SIS	sister
SIT	Stay in touch
SITD	Still in the dark
SJW	Social justice warrior
SK8	Skate
SK8NG	Skating
SK8R	Skater
SK8RBOI	Skater Boy
SLAP	Sounds like a plan
SM	Social media
SMAZED	Smoky haze
SMEXI	Combination of sexy and Mexican, used to describe attractive people
SMH	Shaking my head
SMHID	Scratching my head in disbelief
SNAFU	Situation normal all fouled up
SNERT	Snot nosed egotistical rude teenager
SNR	Streaks and Recents
SO	Significant other
SOAB	Son of a Bitch
SOK	It's
SOL	Sooner or later
SOMY	Sick of me yet?
SOS	Son of Sam
SOS	save our souls
SOT	Short of time
SOTMG	Short of time, must go
SOWM	Someone with me
SPK	Speak
SPST	Same place, same time
SPTO	Spoke to
SQ	Square
SRSLY	Seriously
SRY	Sorry
SS	So sorry
SSDD	Same stuff, different day
SSIF	So stupid it's funny
SSINF	So stupid it's not funny
ST&D	Stop texting and drive
STFU	Shut the fuck up
STR8	Straight
STW	Search the Web
SU	Shut up
SUITM	See you in the morning
SUL	See you later
SUP	What's up?
SUTH	So used to haters
SUX	sucks
SUYF	Shut up you fool
SWAG	Scientific wild a guess
SWAG	free stuff
SWAK	Sealed with a kiss
SWALK	Sealed with a loving kiss
SWAT	Scientific wild butt guess
SWL	Screaming with laughter
SWMBO	She who must be obeyed.
SYL	See you later
SYS	See you soon
SYY	Shut your yapper
Slay	To succeed at something
SorG	Straight or Gay?
Stan	die-hard fan
T+	Think positive
T4BU	Thanks for being you
T:)T	Think happy thoughts
TA	Thanks a lot
TAFN	That's all for now
TAM	Tomorro a.m.
TANK	really strong
TANKED	owned
TANKING	owning
TARFU	Things Are Really fouled Up.
TAU	Thinking about you
TAUMUALU	Thinking about you miss you always love you
TBBH	To be brutally honest
TBC	To be continued
TBD	To be determined
TBH	To be honest
TBL	Text back later
TBT	Throwback Thursday
TC	Take care
TCB	Take care of business
TCOY	Take care of yourself
TD2M	Talk dirty to me
TDTM	Talk dirty to me
TEA	gossip
TFF	Too fucking funny
TFS	Thanks for sharing
TFTF	Thanks for the follow
TFTI	Thanks for the invitation
TFTT	Thanks for this tweet
TG	Thank goodness
TGIF	Thank God it's Friday
THNQ	Thank-you
THNX	Thanks
THOT	That whre over there
THT	Think happy thoughts
THX	Thanks
TIA	Thanks in advance
TIAD	Tomorrow is another day
TIC	Tongue-in-cheek
TIL	Today I learned
TILIS	Tell it like it is
TIR	Teacher in room
TL	Too long
TL;DR	Too long; didn't read
TLK2UL8R	Talk to you later
TM	Trust me
TMA	Take my advice
TMB	Text me back
TMB	Tweet me back
TMI	Too much information
TMOT	Trust me on this
TMTH	Too much to handle
TMWFI	Take my word for it
TMYL	Tell me your location
TNSTAAFL	There's no such thing as a free lunch
TNT	Til next time
TOJ	Tears of joy
TOS	Terms of service
TOTES	Totally
TOU	Thinking of you
TOY	Thinking of you
TPM	Tomorrow p.m.
TPTB	The powers that be
TQ	Te quiero or I love you
TSH	Tripping so hard
TSNF	That's so not fair
TSTB	The sooner, the better
TT	Trending topic
TTFN	Ta ta for now
TTG	Time to go
TTLY	Totally
TTTT	These things take time
TTUL	Talk to you later
TTYAFN	Talk to you awhile from now
TTYL	Talk to you later
TTYS	Talk to you soon
TU	Thank you
TUI	Turning you in
TURNT	turned up
TWSS	That's what she said
TX	Thanks
TY	Thank you
TYAFY	Thank you and fuck you
TYFYC	Thank you for your comment
TYS	Told you so
TYSO	Thank you so much
TYT	Take your time
TYVM	Thank you very much
U-L	mEYou will
UCMU	You crack me up
UDI	Unidentified drinking injury
UDM	You the man
UDS	Ugly domestic scene
UFB	Un fucking believable
UFN	Until further notice
UFWM	You fucking with me?
UGTBK	You've got to be kidding
UHGTBSM	You have got to be s#$ting me!
UKTR	You know that's right
UL	Upload
UN4TUN8	Unfortunate
UNA	Use no acronyms
UNBLEFBLE	Unbelievable
UNCRTN	Uncertain
UNPC	Un-politically correct
UOK	You ok?
UR	You are
UR2YS4ME	You are too wise for me
URA	You are a star
URH	You are hot
URSKTM	You are so kind to me
URTM	You are the man
URW	You are welcome
USBCA	Until something better comes along
USU	Usually
UT	Unreal Tournament
UT2L	You take too long
UTM	You tell me
UV	Unpleasant visual
UW	You're welcome
UX	User experience
V	Very
VAT	Value added tax
VBL	Visible bra line
VBS	Very big smile
VC	Voice chat
VEG	Very evil grin
VFF	Very fucking funny
VFM	Value for money
VGC	Very good condition
VIP	Very important person
VM	Voice mail
VN	Very nice
VRY	Very
VSC	Very soft chuckle
VSF	Very sad face
W3	WWW
W8	Wait
W@	What?
WAH	Working at home
WAJ	What a jerk
WAM	Wait a minute
WAN2	Want to?
WAN2TLK	Want to talk
WAREZ	pirated software
WAS	Wait a second
WAS	Wild a guess
WAT	What
WAWA	Where are we at?
WAYF	Where are you from?
WB	Welcome back
WBS	Write back soon
WBU	What about you?
WC	Welcome
WC	Who cares
WCA	Who cares anyway
WDALYIC	Who died and left you in charge
WDYK	What do you know?
WDYT	What do you think?
WE	Whatever
WEBO	Webopedia
WEEBO	Describes a person obsessed with of Japanese culture
WGACA	What do you think?
WH5	Who, what, when, where, why
WHATEVES	Whatever
WIBNI	Wouldn't it be nice if
WIIFM	What's in it for me?
WISP	Winning is so pleasurable
WITP	What is the point?
WITW	What in the world
WIU	Wrap it up
WK	Week
WKD	Weekend
WL	Whatta loser
WOA	Work of Art
WOKE	Slang for people who are aware of current social issues, and politics
WOMBAT	Waste of money, brains and time
WOW	World of Warcraft
WRK	Work
WRT	With regard to
WRU	Where are you?
WRU@	Where are you at?
WRUD	What are you doing?
WTF	What the fuck ?
WTFE	What the fuck ever
WTFO	What the fuck ?, over.
WTG	Way to go
WTGP	Want to go private?
WTH	What the heck?
WTM	Who's the man?
WU	What's up?
WUCIWUG	What you see is what you get
WUF	Where are you from?
WUP	What's up?
WUT	what
WUU2	What are you up to?
WUW	What you want?
WUZ	was
WWJD	What would Jesus do?
WWNC	Will wonders never cease
WWYC	Write when you can
WYCM	Will you call me?
WYD	What you doing?
WYGAM	When you get a minute
WYHAM	When you have a minute
WYLEI	When you least expect it
WYSIWYG	What you see is what you get
WYWH	Wish you were here
X	Kiss
XLNT	Excellent
XLR8	faster
XME	Excuse Me
XOXOXO	Hugs & Kisses
XPOST	Cross-post
XYL	Ex-young lady
XYZ	Examine your zipper
Y2K	You're too kind
Y?	Why?
YA	Young adult
YAA	Yet another acronym
YABA	Yet another bloody acronym
YARLY	Ya, really?
YAS	praise
YBIC	Your brother in Christ
YBS	You'll be sorry
YCDBWYCID	You can't do business when your computer is down
YCHT	You can have them
YCLIU	You can look it up
YCMU	You crack me up
YCT	Your comment to?
YD	Yesterday
YEET	excitement
YF	Wife
YG	Young gentleman
YGG	You go girl
YGTBKM	You've got to be kidding me
YGTR	You got that right
YHBT	You have been trolled
YHBW	You have been warned
YHL	You have lost
YIU	Yes, I understand
YKW	You know what
YKWYCD	You know what you can do
YL	Young lady
YMMV	Your mileage may vary
YNK	You never know
YOLO	You only live once
YR	Yeah right
YR	Your
YRYOCC	You're running your own cuckoo clock
YSIC	Your sister in Christ
YSYD	Yeah sure you do
YT	You there?
YT	YouTube
YTB	You're the best
YTB	Youth talk back
YTG	You're the greatest
YTTL	You take too long
YW	You're welcome
YWHNB	Yes, we have no bananas
YWHOL	Yelling “woohoo” out loud
YWSYLS	You win some, you lose some
YYSSW	Yeah, yeah, sure, sure, whatever
Z	Z's are calling
Z%	Zoo
ZH	Sleeping Hour
ZOT	Zero tolerance
ZUP	What's up?
ZZZZ	Sleeping
^5	High-five
^URS	Up yours
